"filename", "language", "C++", "Markdown", "JSON", "JavaScript", "comment", "blank", "total"
"c:\Users\Aqua\Programming\AeroJS\.github\PULL_REQUEST_TEMPLATE.md", "Markdown", 0, 0, 0, 0, 0, 1, 1
"c:\Users\Aqua\Programming\AeroJS\CHANGELOG.md", "Markdown", 0, 0, 0, 0, 0, 1, 1
"c:\Users\Aqua\Programming\AeroJS\CODE_OF_CONDUCT.md", "Markdown", 0, 0, 0, 0, 0, 1, 1
"c:\Users\Aqua\Programming\AeroJS\CONTRIBUTING.md", "Markdown", 0, 0, 0, 0, 0, 1, 1
"c:\Users\Aqua\Programming\AeroJS\FINAL_IMPLEMENTATION_GUIDE.md", "Markdown", 0, 233, 0, 0, 0, 78, 311
"c:\Users\Aqua\Programming\AeroJS\IMPLEMENTATION_SUMMARY.md", "Markdown", 0, 165, 0, 0, 0, 34, 199
"c:\Users\Aqua\Programming\AeroJS\README.md", "Markdown", 0, 203, 0, 0, 0, 57, 260
"c:\Users\Aqua\Programming\AeroJS\SUMMARY.md", "Markdown", 0, 49, 0, 0, 0, 18, 67
"c:\Users\Aqua\Programming\AeroJS\docs\api\core.md", "Markdown", 0, 201, 0, 0, 0, 74, 275
"c:\Users\Aqua\Programming\AeroJS\docs\api\jit.md", "Markdown", 0, 334, 0, 0, 0, 115, 449
"c:\Users\Aqua\Programming\AeroJS\docs\api\parser.md", "Markdown", 0, 809, 0, 0, 0, 237, 1046
"c:\Users\Aqua\Programming\AeroJS\docs\api\transformers.md", "Markdown", 0, 618, 0, 0, 0, 214, 832
"c:\Users\Aqua\Programming\AeroJS\docs\api\transformers\parallel_array_optimization.md", "Markdown", 0, 154, 0, 0, 0, 52, 206
"c:\Users\Aqua\Programming\AeroJS\docs\api\utils.md", "Markdown", 0, 667, 0, 0, 0, 223, 890
"c:\Users\Aqua\Programming\AeroJS\docs\api\vm.md", "Markdown", 0, 260, 0, 0, 0, 88, 348
"c:\Users\Aqua\Programming\AeroJS\docs\implemented_features.md", "Markdown", 0, 32, 0, 0, 0, 11, 43
"c:\Users\Aqua\Programming\AeroJS\include\aerojs\aerojs.h", "C++", 222, 0, 0, 0, 50, 24, 296
"c:\Users\Aqua\Programming\AeroJS\include\aerojs\arm64_jit.h", "C++", 136, 0, 0, 0, 54, 22, 212
"c:\Users\Aqua\Programming\AeroJS\include\aerojs\context.h", "C++", 145, 0, 0, 0, 316, 55, 516
"c:\Users\Aqua\Programming\AeroJS\include\aerojs\engine.h", "C++", 141, 0, 0, 0, 231, 43, 415
"c:\Users\Aqua\Programming\AeroJS\include\aerojs\hyper_gc.h", "C++", 98, 0, 0, 0, 27, 18, 143
"c:\Users\Aqua\Programming\AeroJS\include\aerojs\jit.h", "C++", 87, 0, 0, 0, 106, 20, 213
"c:\Users\Aqua\Programming\AeroJS\include\aerojs\optimizer.h", "C++", 205, 0, 0, 0, 177, 32, 414
"c:\Users\Aqua\Programming\AeroJS\include\aerojs\parallel.h", "C++", 136, 0, 0, 0, 241, 42, 419
"c:\Users\Aqua\Programming\AeroJS\include\aerojs\quantum_jit.h", "C++", 68, 0, 0, 0, 25, 16, 109
"c:\Users\Aqua\Programming\AeroJS\include\aerojs\simd.h", "C++", 217, 0, 0, 0, 285, 41, 543
"c:\Users\Aqua\Programming\AeroJS\include\aerojs\transformers\parallel_array_optimization.h", "C++", 55, 0, 0, 0, 78, 31, 164
"c:\Users\Aqua\Programming\AeroJS\include\aerojs\ultra_parser.h", "C++", 168, 0, 0, 0, 84, 39, 291
"c:\Users\Aqua\Programming\AeroJS\include\aerojs\value.h", "C++", 115, 0, 0, 0, 87, 67, 269
"c:\Users\Aqua\Programming\AeroJS\include\aerojs\world_class_engine.h", "C++", 121, 0, 0, 0, 38, 26, 185
"c:\Users\Aqua\Programming\AeroJS\include\nlohmann\json.hpp", "C++", 17980, 0, 0, 0, 4492, 3055, 25527
"c:\Users\Aqua\Programming\AeroJS\include\nlohmann\json_fwd.hpp", "C++", 24, 0, 0, 0, 7, 7, 38
"c:\Users\Aqua\Programming\AeroJS\rules\directory_structure.md", "Markdown", 0, 376, 0, 0, 0, 25, 401
"c:\Users\Aqua\Programming\AeroJS\rules\specifications.md", "Markdown", 0, 519, 0, 0, 0, 151, 670
"c:\Users\Aqua\Programming\AeroJS\rules\technical_requirements.md", "Markdown", 0, 513, 0, 0, 0, 26, 539
"c:\Users\Aqua\Programming\AeroJS\src\core\README.md", "Markdown", 0, 29, 0, 0, 0, 14, 43
"c:\Users\Aqua\Programming\AeroJS\src\core\context.cpp", "C++", 85, 0, 0, 0, 14, 19, 118
"c:\Users\Aqua\Programming\AeroJS\src\core\context.h", "C++", 168, 0, 0, 0, 48, 44, 260
"c:\Users\Aqua\Programming\AeroJS\src\core\dummy.cpp", "C++", 16, 0, 0, 0, 11, 7, 34
"c:\Users\Aqua\Programming\AeroJS\src\core\engine.cpp", "C++", 536, 0, 0, 0, 50, 119, 705
"c:\Users\Aqua\Programming\AeroJS\src\core\engine.h", "C++", 150, 0, 0, 0, 39, 30, 219
"c:\Users\Aqua\Programming\AeroJS\src\core\exception.cpp", "C++", 222, 0, 0, 0, 45, 48, 315
"c:\Users\Aqua\Programming\AeroJS\src\core\exception.h", "C++", 67, 0, 0, 0, 70, 23, 160
"c:\Users\Aqua\Programming\AeroJS\src\core\hyper_gc.cpp", "C++", 170, 0, 0, 0, 24, 61, 255
"c:\Users\Aqua\Programming\AeroJS\src\core\jit\README.md", "Markdown", 0, 72, 0, 0, 0, 23, 95
"c:\Users\Aqua\Programming\AeroJS\src\core\jit\advanced_jit.h", "C++", 146, 0, 0, 0, 50, 33, 229
"c:\Users\Aqua\Programming\AeroJS\src\core\jit\arch_support.h", "C++", 58, 0, 0, 0, 29, 12, 99
"c:\Users\Aqua\Programming\AeroJS\src\core\jit\backend\arm64\arm64_assembler.cpp", "C++", 518, 0, 0, 0, 112, 93, 723
"c:\Users\Aqua\Programming\AeroJS\src\core\jit\backend\arm64\arm64_assembler.h", "C++", 358, 0, 0, 0, 62, 76, 496
"c:\Users\Aqua\Programming\AeroJS\src\core\jit\backend\arm64\arm64_backend.cpp", "C++", 934, 0, 0, 0, 188, 218, 1340
"c:\Users\Aqua\Programming\AeroJS\src\core\jit\backend\arm64\arm64_backend.h", "C++", 102, 0, 0, 0, 80, 41, 223
"c:\Users\Aqua\Programming\AeroJS\src\core\jit\backend\arm64\arm64_branch.cpp", "C++", 210, 0, 0, 0, 73, 60, 343
"c:\Users\Aqua\Programming\AeroJS\src\core\jit\backend\arm64\arm64_branch.h", "C++", 71, 0, 0, 0, 126, 26, 223
"c:\Users\Aqua\Programming\AeroJS\src\core\jit\backend\arm64\arm64_code_gen.cpp", "C++", 780, 0, 0, 0, 172, 211, 1163
"c:\Users\Aqua\Programming\AeroJS\src\core\jit\backend\arm64\arm64_code_gen.h", "C++", 201, 0, 0, 0, 45, 45, 291
"c:\Users\Aqua\Programming\AeroJS\src\core\jit\backend\arm64\arm64_code_generator.cpp", "C++", 339, 0, 0, 0, 77, 54, 470
"c:\Users\Aqua\Programming\AeroJS\src\core\jit\backend\arm64\arm64_code_generator.h", "C++", 24, 0, 0, 0, 49, 14, 87
"c:\Users\Aqua\Programming\AeroJS\src\core\jit\backend\arm64\arm64_features.cpp", "C++", 219, 0, 0, 0, 66, 45, 330
"c:\Users\Aqua\Programming\AeroJS\src\core\jit\backend\arm64\arm64_jit_compiler.cpp", "C++", 1038, 0, 0, 0, 223, 295, 1556
"c:\Users\Aqua\Programming\AeroJS\src\core\jit\backend\arm64\arm64_jit_compiler.h", "C++", 293, 0, 0, 0, 80, 76, 449
"c:\Users\Aqua\Programming\AeroJS\src\core\jit\backend\arm64\arm64_simd.cpp", "C++", 570, 0, 0, 0, 162, 181, 913
"c:\Users\Aqua\Programming\AeroJS\src\core\jit\backend\arm64\arm64_simd.h", "C++", 87, 0, 0, 0, 165, 28, 280
"c:\Users\Aqua\Programming\AeroJS\src\core\jit\backend\arm64\arm64_sve.cpp", "C++", 1154, 0, 0, 0, 500, 374, 2028
"c:\Users\Aqua\Programming\AeroJS\src\core\jit\backend\arm64\arm64_sve.h", "C++", 72, 0, 0, 0, 197, 29, 298
"c:\Users\Aqua\Programming\AeroJS\src\core\jit\backend\backend_factory.cpp", "C++", 443, 0, 0, 0, 68, 85, 596
"c:\Users\Aqua\Programming\AeroJS\src\core\jit\backend\backend_factory.h", "C++", 26, 0, 0, 0, 43, 14, 83
"c:\Users\Aqua\Programming\AeroJS\src\core\jit\backend\riscv\riscv_branch.cpp", "C++", 175, 0, 0, 0, 33, 49, 257
"c:\Users\Aqua\Programming\AeroJS\src\core\jit\backend\riscv\riscv_branch.h", "C++", 46, 0, 0, 0, 98, 21, 165
"c:\Users\Aqua\Programming\AeroJS\src\core\jit\backend\riscv\riscv_code_generator.cpp", "C++", 1388, 0, 0, 0, 395, 339, 2122
"c:\Users\Aqua\Programming\AeroJS\src\core\jit\backend\riscv\riscv_code_generator.h", "C++", 149, 0, 0, 0, 37, 34, 220
"c:\Users\Aqua\Programming\AeroJS\src\core\jit\backend\riscv\riscv_jit_compiler.cpp", "C++", 1481, 0, 0, 0, 349, 434, 2264
"c:\Users\Aqua\Programming\AeroJS\src\core\jit\backend\riscv\riscv_jit_compiler.h", "C++", 273, 0, 0, 0, 45, 38, 356
"c:\Users\Aqua\Programming\AeroJS\src\core\jit\backend\riscv\riscv_vector.cpp", "C++", 753, 0, 0, 0, 284, 268, 1305
"c:\Users\Aqua\Programming\AeroJS\src\core\jit\backend\riscv\riscv_vector.h", "C++", 87, 0, 0, 0, 350, 48, 485
"c:\Users\Aqua\Programming\AeroJS\src\core\jit\backend\x86_64\jit_x86_64.cpp", "C++", 839, 0, 0, 0, 160, 200, 1199
"c:\Users\Aqua\Programming\AeroJS\src\core\jit\backend\x86_64\jit_x86_64.h", "C++", 177, 0, 0, 0, 113, 50, 340
"c:\Users\Aqua\Programming\AeroJS\src\core\jit\backend\x86_64\x86_64_code_generator.cpp", "C++", 2634, 0, 0, 0, 433, 601, 3668
"c:\Users\Aqua\Programming\AeroJS\src\core\jit\backend\x86_64\x86_64_code_generator.h", "C++", 327, 0, 0, 0, 137, 81, 545
"c:\Users\Aqua\Programming\AeroJS\src\core\jit\backend\x86_64\x86_64_registers.cpp", "C++", 193, 0, 0, 0, 21, 41, 255
"c:\Users\Aqua\Programming\AeroJS\src\core\jit\backend\x86_64\x86_64_registers.h", "C++", 80, 0, 0, 0, 95, 30, 205
"c:\Users\Aqua\Programming\AeroJS\src\core\jit\baseline\baseline_jit.cpp", "C++", 1010, 0, 0, 0, 358, 281, 1649
"c:\Users\Aqua\Programming\AeroJS\src\core\jit\baseline\baseline_jit.h", "C++", 39, 0, 0, 0, 24, 18, 81
"c:\Users\Aqua\Programming\AeroJS\src\core\jit\baseline\bytecode_decoder.cpp", "C++", 190, 0, 0, 0, 12, 33, 235
"c:\Users\Aqua\Programming\AeroJS\src\core\jit\baseline\bytecode_decoder.h", "C++", 60, 0, 0, 0, 50, 20, 130
"c:\Users\Aqua\Programming\AeroJS\src\core\jit\baseline\bytecode_emitter.h", "C++", 72, 0, 0, 0, 29, 23, 124
"c:\Users\Aqua\Programming\AeroJS\src\core\jit\baseline\code_profiler.cpp", "C++", 448, 0, 0, 0, 45, 118, 611
"c:\Users\Aqua\Programming\AeroJS\src\core\jit\baseline\code_profiler.h", "C++", 143, 0, 0, 0, 160, 52, 355
"c:\Users\Aqua\Programming\AeroJS\src\core\jit\baseline\inline_cache_manager.cpp", "C++", 343, 0, 0, 0, 35, 96, 474
"c:\Users\Aqua\Programming\AeroJS\src\core\jit\baseline\inline_cache_manager.h", "C++", 103, 0, 0, 0, 167, 52, 322
"c:\Users\Aqua\Programming\AeroJS\src\core\jit\baseline\ir_builder.cpp", "C++", 317, 0, 0, 0, 55, 51, 423
"c:\Users\Aqua\Programming\AeroJS\src\core\jit\baseline\ir_builder.h", "C++", 31, 0, 0, 0, 34, 17, 82
"c:\Users\Aqua\Programming\AeroJS\src\core\jit\baseline\ir_generator.cpp", "C++", 309, 0, 0, 0, 57, 67, 433
"c:\Users\Aqua\Programming\AeroJS\src\core\jit\baseline\ir_generator.h", "C++", 41, 0, 0, 0, 100, 27, 168
"c:\Users\Aqua\Programming\AeroJS\src\core\jit\baseline\ir_optimizer.cpp", "C++", 723, 0, 0, 0, 112, 169, 1004
"c:\Users\Aqua\Programming\AeroJS\src\core\jit\baseline\ir_optimizer.h", "C++", 106, 0, 0, 0, 128, 41, 275
"c:\Users\Aqua\Programming\AeroJS\src\core\jit\baseline\ir_validator.cpp", "C++", 509, 0, 0, 0, 52, 96, 657
"c:\Users\Aqua\Programming\AeroJS\src\core\jit\baseline\ir_validator.h", "C++", 73, 0, 0, 0, 87, 26, 186
"c:\Users\Aqua\Programming\AeroJS\src\core\jit\baseline\register_allocator.cpp", "C++", 318, 0, 0, 0, 56, 53, 427
"c:\Users\Aqua\Programming\AeroJS\src\core\jit\baseline\register_allocator.h", "C++", 64, 0, 0, 0, 82, 27, 173
"c:\Users\Aqua\Programming\AeroJS\src\core\jit\baseline\simd_optimizer.h", "C++", 105, 0, 0, 0, 105, 31, 241
"c:\Users\Aqua\Programming\AeroJS\src\core\jit\baseline\type_inference.cpp", "C++", 387, 0, 0, 0, 54, 101, 542
"c:\Users\Aqua\Programming\AeroJS\src\core\jit\baseline\type_inference.h", "C++", 97, 0, 0, 0, 180, 50, 327
"c:\Users\Aqua\Programming\AeroJS\src\core\jit\bytecode\bytecode.cpp", "C++", 353, 0, 0, 0, 24, 79, 456
"c:\Users\Aqua\Programming\AeroJS\src\core\jit\bytecode\bytecode.h", "C++", 340, 0, 0, 0, 30, 66, 436
"c:\Users\Aqua\Programming\AeroJS\src\core\jit\bytecode\bytecode_function.h", "C++", 43, 0, 0, 0, 96, 25, 164
"c:\Users\Aqua\Programming\AeroJS\src\core\jit\bytecode\bytecode_generator.h", "C++", 562, 0, 0, 0, 127, 145, 834
"c:\Users\Aqua\Programming\AeroJS\src\core\jit\bytecode\bytecode_instruction.cpp", "C++", 226, 0, 0, 0, 12, 42, 280
"c:\Users\Aqua\Programming\AeroJS\src\core\jit\bytecode\bytecode_instruction.h", "C++", 104, 0, 0, 0, 137, 41, 282
"c:\Users\Aqua\Programming\AeroJS\src\core\jit\bytecode\bytecode_module.cpp", "C++", 179, 0, 0, 0, 7, 38, 224
"c:\Users\Aqua\Programming\AeroJS\src\core\jit\bytecode\bytecode_module.h", "C++", 88, 0, 0, 0, 66, 29, 183
"c:\Users\Aqua\Programming\AeroJS\src\core\jit\bytecode\bytecode_opcodes.h", "C++", 399, 0, 0, 0, 40, 70, 509
"c:\Users\Aqua\Programming\AeroJS\src\core\jit\bytecode\bytecode_parser.cpp", "C++", 204, 0, 0, 0, 33, 49, 286
"c:\Users\Aqua\Programming\AeroJS\src\core\jit\bytecode\bytecode_parser.h", "C++", 257, 0, 0, 0, 41, 59, 357
"c:\Users\Aqua\Programming\AeroJS\src\core\jit\bytecode\bytecode_structure.h", "C++", 279, 0, 0, 0, 36, 50, 365
"c:\Users\Aqua\Programming\AeroJS\src\core\jit\code_cache.cpp", "C++", 197, 0, 0, 0, 36, 53, 286
"c:\Users\Aqua\Programming\AeroJS\src\core\jit\code_cache.h", "C++", 339, 0, 0, 0, 96, 84, 519
"c:\Users\Aqua\Programming\AeroJS\src\core\jit\deoptimizer\deoptimizer.cpp", "C++", 262, 0, 0, 0, 53, 66, 381
"c:\Users\Aqua\Programming\AeroJS\src\core\jit\deoptimizer\deoptimizer.h", "C++", 44, 0, 0, 0, 40, 15, 99
"c:\Users\Aqua\Programming\AeroJS\src\core\jit\ic\arm64_ic_generator.cpp", "C++", 433, 0, 0, 0, 254, 199, 886
"c:\Users\Aqua\Programming\AeroJS\src\core\jit\ic\arm64_ic_generator.h", "C++", 17, 0, 0, 0, 41, 10, 68
"c:\Users\Aqua\Programming\AeroJS\src\core\jit\ic\code_buffer.cpp", "C++", 119, 0, 0, 0, 24, 27, 170
"c:\Users\Aqua\Programming\AeroJS\src\core\jit\ic\ic_code_generator.cpp", "C++", 258, 0, 0, 0, 72, 77, 407
"c:\Users\Aqua\Programming\AeroJS\src\core\jit\ic\ic_code_generator.h", "C++", 105, 0, 0, 0, 200, 41, 346
"c:\Users\Aqua\Programming\AeroJS\src\core\jit\ic\ic_logger.cpp", "C++", 625, 0, 0, 0, 69, 181, 875
"c:\Users\Aqua\Programming\AeroJS\src\core\jit\ic\ic_logger.h", "C++", 206, 0, 0, 0, 347, 91, 644
"c:\Users\Aqua\Programming\AeroJS\src\core\jit\ic\ic_optimizer.cpp", "C++", 1700, 0, 0, 0, 298, 328, 2326
"c:\Users\Aqua\Programming\AeroJS\src\core\jit\ic\ic_optimizer.h", "C++", 265, 0, 0, 0, 247, 52, 564
"c:\Users\Aqua\Programming\AeroJS\src\core\jit\ic\ic_performance_analyzer.cpp", "C++", 847, 0, 0, 0, 126, 225, 1198
"c:\Users\Aqua\Programming\AeroJS\src\core\jit\ic\ic_performance_analyzer.h", "C++", 188, 0, 0, 0, 53, 60, 301
"c:\Users\Aqua\Programming\AeroJS\src\core\jit\ic\ic_visualization.cpp", "C++", 707, 0, 0, 0, 92, 159, 958
"c:\Users\Aqua\Programming\AeroJS\src\core\jit\ic\ic_visualization.h", "C++", 177, 0, 0, 0, 197, 45, 419
"c:\Users\Aqua\Programming\AeroJS\src\core\jit\ic\ic_visualizer.cpp", "C++", 850, 0, 0, 0, 81, 193, 1124
"c:\Users\Aqua\Programming\AeroJS\src\core\jit\ic\ic_visualizer.h", "C++", 213, 0, 0, 0, 169, 46, 428
"c:\Users\Aqua\Programming\AeroJS\src\core\jit\ic\inline_cache.cpp", "C++", 369, 0, 0, 0, 85, 107, 561
"c:\Users\Aqua\Programming\AeroJS\src\core\jit\ic\inline_cache.h", "C++", 639, 0, 0, 0, 188, 157, 984
"c:\Users\Aqua\Programming\AeroJS\src\core\jit\ic\riscv_ic_generator.cpp", "C++", 362, 0, 0, 0, 264, 182, 808
"c:\Users\Aqua\Programming\AeroJS\src\core\jit\ic\riscv_ic_generator.h", "C++", 17, 0, 0, 0, 41, 10, 68
"c:\Users\Aqua\Programming\AeroJS\src\core\jit\ic\x86_64_ic_generator.cpp", "C++", 297, 0, 0, 0, 210, 133, 640
"c:\Users\Aqua\Programming\AeroJS\src\core\jit\ir\constant_folding.cpp", "C++", 330, 0, 0, 0, 57, 72, 459
"c:\Users\Aqua\Programming\AeroJS\src\core\jit\ir\dead_code_elimination.cpp", "C++", 175, 0, 0, 0, 21, 38, 234
"c:\Users\Aqua\Programming\AeroJS\src\core\jit\ir\ir.h", "C++", 282, 0, 0, 0, 111, 52, 445
"c:\Users\Aqua\Programming\AeroJS\src\core\jit\ir\ir_builder.cpp", "C++", 933, 0, 0, 0, 206, 190, 1329
"c:\Users\Aqua\Programming\AeroJS\src\core\jit\ir\ir_builder.h", "C++", 315, 0, 0, 0, 112, 59, 486
"c:\Users\Aqua\Programming\AeroJS\src\core\jit\ir\ir_function.cpp", "C++", 658, 0, 0, 0, 86, 195, 939
"c:\Users\Aqua\Programming\AeroJS\src\core\jit\ir\ir_function.h", "C++", 247, 0, 0, 0, 61, 74, 382
"c:\Users\Aqua\Programming\AeroJS\src\core\jit\ir\ir_graph.cpp", "C++", 778, 0, 0, 0, 107, 191, 1076
"c:\Users\Aqua\Programming\AeroJS\src\core\jit\ir\ir_graph.h", "C++", 505, 0, 0, 0, 169, 141, 815
"c:\Users\Aqua\Programming\AeroJS\src\core\jit\ir\ir_instruction.cpp", "C++", 370, 0, 0, 0, 22, 63, 455
"c:\Users\Aqua\Programming\AeroJS\src\core\jit\ir\ir_instruction.h", "C++", 322, 0, 0, 0, 55, 75, 452
"c:\Users\Aqua\Programming\AeroJS\src\core\jit\ir\ir_optimizer.cpp", "C++", 1852, 0, 0, 0, 402, 388, 2642
"c:\Users\Aqua\Programming\AeroJS\src\core\jit\ir\ir_optimizer.h", "C++", 116, 0, 0, 0, 196, 52, 364
"c:\Users\Aqua\Programming\AeroJS\src\core\jit\ir\ir_validator.cpp", "C++", 637, 0, 0, 0, 76, 104, 817
"c:\Users\Aqua\Programming\AeroJS\src\core\jit\ir\ir_validator.h", "C++", 53, 0, 0, 0, 13, 18, 84
"c:\Users\Aqua\Programming\AeroJS\src\core\jit\ir\type_analyzer.cpp", "C++", 614, 0, 0, 0, 117, 129, 860
"c:\Users\Aqua\Programming\AeroJS\src\core\jit\ir\type_analyzer.h", "C++", 145, 0, 0, 0, 126, 46, 317
"c:\Users\Aqua\Programming\AeroJS\src\core\jit\ir\type_specialization.cpp", "C++", 287, 0, 0, 0, 39, 64, 390
"c:\Users\Aqua\Programming\AeroJS\src\core\jit\ir\type_specializer.cpp", "C++", 1292, 0, 0, 0, 190, 219, 1701
"c:\Users\Aqua\Programming\AeroJS\src\core\jit\ir\type_specializer.h", "C++", 118, 0, 0, 0, 148, 34, 300
"c:\Users\Aqua\Programming\AeroJS\src\core\jit\jit_compiler.cpp", "C++", 22, 0, 0, 0, 6, 8, 36
"c:\Users\Aqua\Programming\AeroJS\src\core\jit\jit_compiler.h", "C++", 108, 0, 0, 0, 97, 41, 246
"c:\Users\Aqua\Programming\AeroJS\src\core\jit\jit_manager.cpp", "C++", 891, 0, 0, 0, 173, 211, 1275
"c:\Users\Aqua\Programming\AeroJS\src\core\jit\jit_manager.h", "C++", 117, 0, 0, 0, 103, 37, 257
"c:\Users\Aqua\Programming\AeroJS\src\core\jit\jit_profiler.cpp", "C++", 481, 0, 0, 0, 16, 89, 586
"c:\Users\Aqua\Programming\AeroJS\src\core\jit\jit_profiler.h", "C++", 175, 0, 0, 0, 135, 58, 368
"c:\Users\Aqua\Programming\AeroJS\src\core\jit\memory_manager.cpp", "C++", 219, 0, 0, 0, 20, 34, 273
"c:\Users\Aqua\Programming\AeroJS\src\core\jit\memory_manager.h", "C++", 39, 0, 0, 0, 50, 16, 105
"c:\Users\Aqua\Programming\AeroJS\src\core\jit\metatracing\trace_optimizer.cpp", "C++", 790, 0, 0, 0, 119, 216, 1125
"c:\Users\Aqua\Programming\AeroJS\src\core\jit\metatracing\trace_optimizer.h", "C++", 85, 0, 0, 0, 48, 43, 176
"c:\Users\Aqua\Programming\AeroJS\src\core\jit\metatracing\trace_recorder.cpp", "C++", 1576, 0, 0, 0, 424, 325, 2325
"c:\Users\Aqua\Programming\AeroJS\src\core\jit\metatracing\trace_recorder.h", "C++", 422, 0, 0, 0, 152, 111, 685
"c:\Users\Aqua\Programming\AeroJS\src\core\jit\metatracing\tracing_jit.cpp", "C++", 706, 0, 0, 0, 253, 201, 1160
"c:\Users\Aqua\Programming\AeroJS\src\core\jit\metatracing\tracing_jit.h", "C++", 202, 0, 0, 0, 175, 70, 447
"c:\Users\Aqua\Programming\AeroJS\src\core\jit\optimizing\constant_folding.cpp", "C++", 820, 0, 0, 0, 86, 141, 1047
"c:\Users\Aqua\Programming\AeroJS\src\core\jit\optimizing\constant_folding.h", "C++", 48, 0, 0, 0, 83, 23, 154
"c:\Users\Aqua\Programming\AeroJS\src\core\jit\optimizing\optimizing_jit.cpp", "C++", 732, 0, 0, 0, 170, 187, 1089
"c:\Users\Aqua\Programming\AeroJS\src\core\jit\optimizing\optimizing_jit.h", "C++", 149, 0, 0, 0, 81, 37, 267
"c:\Users\Aqua\Programming\AeroJS\src\core\jit\optimizing\parallel_array_optimization.cpp", "C++", 284, 0, 0, 0, 50, 79, 413
"c:\Users\Aqua\Programming\AeroJS\src\core\jit\optimizing\super_optimizing_jit.cpp", "C++", 344, 0, 0, 0, 62, 68, 474
"c:\Users\Aqua\Programming\AeroJS\src\core\jit\optimizing\super_optimizing_jit.h", "C++", 48, 0, 0, 0, 33, 19, 100
"c:\Users\Aqua\Programming\AeroJS\src\core\jit\optimizing\tiered_jit.cpp", "C++", 138, 0, 0, 0, 38, 45, 221
"c:\Users\Aqua\Programming\AeroJS\src\core\jit\optimizing\tiered_jit.h", "C++", 38, 0, 0, 0, 22, 12, 72
"c:\Users\Aqua\Programming\AeroJS\src\core\jit\profiler\execution_profiler.cpp", "C++", 163, 0, 0, 0, 25, 47, 235
"c:\Users\Aqua\Programming\AeroJS\src\core\jit\profiler\execution_profiler.h", "C++", 56, 0, 0, 0, 63, 22, 141
"c:\Users\Aqua\Programming\AeroJS\src\core\jit\profiler\jit_profiler.cpp", "C++", 220, 0, 0, 0, 48, 77, 345
"c:\Users\Aqua\Programming\AeroJS\src\core\jit\profiler\jit_profiler.h", "C++", 298, 0, 0, 0, 66, 62, 426
"c:\Users\Aqua\Programming\AeroJS\src\core\jit\profiler\profiler.cpp", "C++", 233, 0, 0, 0, 53, 51, 337
"c:\Users\Aqua\Programming\AeroJS\src\core\jit\profiler\profiler.h", "C++", 97, 0, 0, 0, 82, 28, 207
"c:\Users\Aqua\Programming\AeroJS\src\core\jit\profiler\type_info.cpp", "C++", 141, 0, 0, 0, 28, 37, 206
"c:\Users\Aqua\Programming\AeroJS\src\core\jit\profiler\type_info.h", "C++", 197, 0, 0, 0, 78, 70, 345
"c:\Users\Aqua\Programming\AeroJS\src\core\jit\registers\register_allocator.h", "C++", 310, 0, 0, 0, 59, 70, 439
"c:\Users\Aqua\Programming\AeroJS\src\core\jit\registers\x86_64_registers.h", "C++", 206, 0, 0, 0, 23, 36, 265
"c:\Users\Aqua\Programming\AeroJS\src\core\jit\tiered_jit_manager.cpp", "C++", 583, 0, 0, 0, 106, 134, 823
"c:\Users\Aqua\Programming\AeroJS\src\core\jit\tiered_jit_manager.h", "C++", 203, 0, 0, 0, 77, 68, 348
"c:\Users\Aqua\Programming\AeroJS\src\core\mcp\examples\mcp_client_example.cpp", "C++", 115, 0, 0, 0, 30, 38, 183
"c:\Users\Aqua\Programming\AeroJS\src\core\mcp\mcp_manager.cpp", "C++", 112, 0, 0, 0, 15, 38, 165
"c:\Users\Aqua\Programming\AeroJS\src\core\mcp\mcp_manager.h", "C++", 33, 0, 0, 0, 58, 18, 109
"c:\Users\Aqua\Programming\AeroJS\src\core\mcp\mcp_server.cpp", "C++", 487, 0, 0, 0, 89, 131, 707
"c:\Users\Aqua\Programming\AeroJS\src\core\mcp\server\mcp_server.cpp", "C++", 463, 0, 0, 0, 69, 113, 645
"c:\Users\Aqua\Programming\AeroJS\src\core\mcp\server\mcp_server.h", "C++", 196, 0, 0, 0, 247, 63, 506
"c:\Users\Aqua\Programming\AeroJS\src\core\mcp\tool\mcp_tool_manager.cpp", "C++", 480, 0, 0, 0, 58, 119, 657
"c:\Users\Aqua\Programming\AeroJS\src\core\mcp\tool\mcp_tool_manager.h", "C++", 160, 0, 0, 0, 50, 29, 239
"c:\Users\Aqua\Programming\AeroJS\src\core\mcp\tool\tool.cpp", "C++", 30, 0, 0, 0, 7, 8, 45
"c:\Users\Aqua\Programming\AeroJS\src\core\mcp\tool\tool.h", "C++", 30, 0, 0, 0, 62, 17, 109
"c:\Users\Aqua\Programming\AeroJS\src\core\mcp\tool\tool_result.cpp", "C++", 35, 0, 0, 0, 7, 11, 53
"c:\Users\Aqua\Programming\AeroJS\src\core\mcp\tool\tool_result.h", "C++", 39, 0, 0, 0, 52, 16, 107
"c:\Users\Aqua\Programming\AeroJS\src\core\mcp\tools\basic_tools.cpp", "C++", 1528, 0, 0, 0, 75, 216, 1819
"c:\Users\Aqua\Programming\AeroJS\src\core\mcp\tools\basic_tools.h", "C++", 46, 0, 0, 0, 170, 35, 251
"c:\Users\Aqua\Programming\AeroJS\src\core\mcp\utils\mcp_utils.cpp", "C++", 150, 0, 0, 0, 22, 36, 208
"c:\Users\Aqua\Programming\AeroJS\src\core\mcp\utils\mcp_utils.h", "C++", 49, 0, 0, 0, 105, 19, 173
"c:\Users\Aqua\Programming\AeroJS\src\core\network\http_server.cpp", "C++", 1007, 0, 0, 0, 99, 255, 1361
"c:\Users\Aqua\Programming\AeroJS\src\core\network\http_server.h", "C++", 268, 0, 0, 0, 72, 76, 416
"c:\Users\Aqua\Programming\AeroJS\src\core\network\websocket_server.cpp", "C++", 576, 0, 0, 0, 227, 150, 953
"c:\Users\Aqua\Programming\AeroJS\src\core\network\websocket_server.h", "C++", 116, 0, 0, 0, 224, 59, 399
"c:\Users\Aqua\Programming\AeroJS\src\core\object.cpp", "C++", 437, 0, 0, 0, 65, 111, 613
"c:\Users\Aqua\Programming\AeroJS\src\core\object.h", "C++", 249, 0, 0, 0, 166, 61, 476
"c:\Users\Aqua\Programming\AeroJS\src\core\parser\README.md", "Markdown", 0, 70, 0, 0, 0, 20, 90
"c:\Users\Aqua\Programming\AeroJS\src\core\parser\ast\ast_visitor.h", "C++", 82, 0, 0, 0, 10, 12, 104
"c:\Users\Aqua\Programming\AeroJS\src\core\parser\ast\node.h", "C++", 75, 0, 0, 0, 30, 18, 123
"c:\Users\Aqua\Programming\AeroJS\src\core\parser\ast\node_type.h", "C++", 97, 0, 0, 0, 42, 20, 159
"c:\Users\Aqua\Programming\AeroJS\src\core\parser\ast\node_visitor.h", "C++", 44, 0, 0, 0, 17, 8, 69
"c:\Users\Aqua\Programming\AeroJS\src\core\parser\ast\nodes\all_nodes.h", "C++", 374, 0, 0, 0, 44, 30, 448
"c:\Users\Aqua\Programming\AeroJS\src\core\parser\ast\nodes\declarations\function_declaration.cpp", "C++", 144, 0, 0, 0, 33, 36, 213
"c:\Users\Aqua\Programming\AeroJS\src\core\parser\ast\nodes\declarations\function_declaration.h", "C++", 60, 0, 0, 0, 66, 22, 148
"c:\Users\Aqua\Programming\AeroJS\src\core\parser\ast\nodes\declarations\variable_declaration.cpp", "C++", 182, 0, 0, 0, 26, 35, 243
"c:\Users\Aqua\Programming\AeroJS\src\core\parser\ast\nodes\declarations\variable_declaration.h", "C++", 81, 0, 0, 0, 80, 31, 192
"c:\Users\Aqua\Programming\AeroJS\src\core\parser\ast\nodes\expressions\array_expression.cpp", "C++", 92, 0, 0, 0, 11, 21, 124
"c:\Users\Aqua\Programming\AeroJS\src\core\parser\ast\nodes\expressions\array_expression.h", "C++", 44, 0, 0, 0, 105, 20, 169
"c:\Users\Aqua\Programming\AeroJS\src\core\parser\ast\nodes\expressions\arrow_function_expression.cpp", "C++", 349, 0, 0, 0, 505, 116, 970
"c:\Users\Aqua\Programming\AeroJS\src\core\parser\ast\nodes\expressions\arrow_function_expression.h", "C++", 54, 0, 0, 0, 42, 16, 112
"c:\Users\Aqua\Programming\AeroJS\src\core\parser\ast\nodes\expressions\assignment_expression.cpp", "C++", 123, 0, 0, 0, 21, 20, 164
"c:\Users\Aqua\Programming\AeroJS\src\core\parser\ast\nodes\expressions\assignment_expression.h", "C++", 72, 0, 0, 0, 77, 23, 172
"c:\Users\Aqua\Programming\AeroJS\src\core\parser\ast\nodes\expressions\binary_expression.cpp", "C++", 188, 0, 0, 0, 11, 31, 230
"c:\Users\Aqua\Programming\AeroJS\src\core\parser\ast\nodes\expressions\binary_expression.h", "C++", 109, 0, 0, 0, 98, 36, 243
"c:\Users\Aqua\Programming\AeroJS\src\core\parser\ast\nodes\expressions\call_expression.cpp", "C++", 140, 0, 0, 0, 15, 16, 171
"c:\Users\Aqua\Programming\AeroJS\src\core\parser\ast\nodes\expressions\call_expression.h", "C++", 62, 0, 0, 0, 39, 23, 124
"c:\Users\Aqua\Programming\AeroJS\src\core\parser\ast\nodes\expressions\class_expression.cpp", "C++", 71, 0, 0, 0, 1, 9, 81
"c:\Users\Aqua\Programming\AeroJS\src\core\parser\ast\nodes\expressions\class_expression.h", "C++", 40, 0, 0, 0, 6, 10, 56
"c:\Users\Aqua\Programming\AeroJS\src\core\parser\ast\nodes\expressions\conditional_expression.cpp", "C++", 84, 0, 0, 0, 17, 20, 121
"c:\Users\Aqua\Programming\AeroJS\src\core\parser\ast\nodes\expressions\conditional_expression.h", "C++", 50, 0, 0, 0, 50, 20, 120
"c:\Users\Aqua\Programming\AeroJS\src\core\parser\ast\nodes\expressions\function_expression.cpp", "C++", 229, 0, 0, 0, 38, 43, 310
"c:\Users\Aqua\Programming\AeroJS\src\core\parser\ast\nodes\expressions\function_expression.h", "C++", 60, 0, 0, 0, 66, 22, 148
"c:\Users\Aqua\Programming\AeroJS\src\core\parser\ast\nodes\expressions\identifier.cpp", "C++", 38, 0, 0, 0, 13, 13, 64
"c:\Users\Aqua\Programming\AeroJS\src\core\parser\ast\nodes\expressions\identifier.h", "C++", 50, 0, 0, 0, 45, 23, 118
"c:\Users\Aqua\Programming\AeroJS\src\core\parser\ast\nodes\expressions\import_expression.cpp", "C++", 81, 0, 0, 0, 20, 17, 118
"c:\Users\Aqua\Programming\AeroJS\src\core\parser\ast\nodes\expressions\import_expression.h", "C++", 46, 0, 0, 0, 45, 18, 109
"c:\Users\Aqua\Programming\AeroJS\src\core\parser\ast\nodes\expressions\literal.cpp", "C++", 98, 0, 0, 0, 14, 18, 130
"c:\Users\Aqua\Programming\AeroJS\src\core\parser\ast\nodes\expressions\literal.h", "C++", 60, 0, 0, 0, 45, 20, 125
"c:\Users\Aqua\Programming\AeroJS\src\core\parser\ast\nodes\expressions\literals.cpp", "C++", 109, 0, 0, 0, 17, 19, 145
"c:\Users\Aqua\Programming\AeroJS\src\core\parser\ast\nodes\expressions\literals.h", "C++", 79, 0, 0, 0, 116, 26, 221
"c:\Users\Aqua\Programming\AeroJS\src\core\parser\ast\nodes\expressions\member_expression.cpp", "C++", 73, 0, 0, 0, 13, 10, 96
"c:\Users\Aqua\Programming\AeroJS\src\core\parser\ast\nodes\expressions\member_expression.h", "C++", 44, 0, 0, 0, 32, 14, 90
"c:\Users\Aqua\Programming\AeroJS\src\core\parser\ast\nodes\expressions\meta_property.cpp", "C++", 70, 0, 0, 0, 26, 18, 114
"c:\Users\Aqua\Programming\AeroJS\src\core\parser\ast\nodes\expressions\meta_property.h", "C++", 47, 0, 0, 0, 44, 18, 109
"c:\Users\Aqua\Programming\AeroJS\src\core\parser\ast\nodes\expressions\object_expression.cpp", "C++", 75, 0, 0, 0, 8, 13, 96
"c:\Users\Aqua\Programming\AeroJS\src\core\parser\ast\nodes\expressions\object_expression.h", "C++", 33, 0, 0, 0, 27, 16, 76
"c:\Users\Aqua\Programming\AeroJS\src\core\parser\ast\nodes\expressions\private_identifier.cpp", "C++", 40, 0, 0, 0, 10, 13, 63
"c:\Users\Aqua\Programming\AeroJS\src\core\parser\ast\nodes\expressions\private_identifier.h", "C++", 27, 0, 0, 0, 26, 14, 67
"c:\Users\Aqua\Programming\AeroJS\src\core\parser\ast\nodes\expressions\property.cpp", "C++", 121, 0, 0, 0, 7, 21, 149
"c:\Users\Aqua\Programming\AeroJS\src\core\parser\ast\nodes\expressions\property.h", "C++", 55, 0, 0, 0, 32, 16, 103
"c:\Users\Aqua\Programming\AeroJS\src\core\parser\ast\nodes\expressions\sequence_expression.cpp", "C++", 75, 0, 0, 0, 14, 15, 104
"c:\Users\Aqua\Programming\AeroJS\src\core\parser\ast\nodes\expressions\sequence_expression.h", "C++", 42, 0, 0, 0, 36, 16, 94
"c:\Users\Aqua\Programming\AeroJS\src\core\parser\ast\nodes\expressions\super.cpp", "C++", 37, 0, 0, 0, 13, 12, 62
"c:\Users\Aqua\Programming\AeroJS\src\core\parser\ast\nodes\expressions\super.h", "C++", 36, 0, 0, 0, 28, 13, 77
"c:\Users\Aqua\Programming\AeroJS\src\core\parser\ast\nodes\expressions\template_literal.cpp", "C++", 143, 0, 0, 0, 4, 19, 166
"c:\Users\Aqua\Programming\AeroJS\src\core\parser\ast\nodes\expressions\template_literal.h", "C++", 81, 0, 0, 0, 18, 20, 119
"c:\Users\Aqua\Programming\AeroJS\src\core\parser\ast\nodes\expressions\this_expression.cpp", "C++", 34, 0, 0, 0, 7, 12, 53
"c:\Users\Aqua\Programming\AeroJS\src\core\parser\ast\nodes\expressions\this_expression.h", "C++", 23, 0, 0, 0, 20, 11, 54
"c:\Users\Aqua\Programming\AeroJS\src\core\parser\ast\nodes\expressions\unary_expression.cpp", "C++", 145, 0, 0, 0, 19, 29, 193
"c:\Users\Aqua\Programming\AeroJS\src\core\parser\ast\nodes\expressions\unary_expression.h", "C++", 73, 0, 0, 0, 55, 27, 155
"c:\Users\Aqua\Programming\AeroJS\src\core\parser\ast\nodes\expressions\yield_await.cpp", "C++", 86, 0, 0, 0, 2, 14, 102
"c:\Users\Aqua\Programming\AeroJS\src\core\parser\ast\nodes\expressions\yield_await.h", "C++", 51, 0, 0, 0, 10, 14, 75
"c:\Users\Aqua\Programming\AeroJS\src\core\parser\ast\nodes\node.cpp", "C++", 126, 0, 0, 0, 72, 33, 231
"c:\Users\Aqua\Programming\AeroJS\src\core\parser\ast\nodes\node.h", "C++", 223, 0, 0, 0, 191, 47, 461
"c:\Users\Aqua\Programming\AeroJS\src\core\parser\ast\nodes\patterns\array_pattern.cpp", "C++", 156, 0, 0, 0, 114, 41, 311
"c:\Users\Aqua\Programming\AeroJS\src\core\parser\ast\nodes\patterns\array_pattern.h", "C++", 35, 0, 0, 0, 94, 23, 152
"c:\Users\Aqua\Programming\AeroJS\src\core\parser\ast\nodes\patterns\assignment_pattern.cpp", "C++", 148, 0, 0, 0, 28, 26, 202
"c:\Users\Aqua\Programming\AeroJS\src\core\parser\ast\nodes\patterns\assignment_pattern.h", "C++", 41, 0, 0, 0, 95, 23, 159
"c:\Users\Aqua\Programming\AeroJS\src\core\parser\ast\nodes\patterns\object_pattern.cpp", "C++", 202, 0, 0, 0, 38, 31, 271
"c:\Users\Aqua\Programming\AeroJS\src\core\parser\ast\nodes\patterns\object_pattern.h", "C++", 41, 0, 0, 0, 101, 24, 166
"c:\Users\Aqua\Programming\AeroJS\src\core\parser\ast\nodes\patterns\rest_spread.cpp", "C++", 77, 0, 0, 0, 2, 6, 85
"c:\Users\Aqua\Programming\AeroJS\src\core\parser\ast\nodes\program.cpp", "C++", 132, 0, 0, 0, 97, 40, 269
"c:\Users\Aqua\Programming\AeroJS\src\core\parser\ast\nodes\program.h", "C++", 84, 0, 0, 0, 42, 19, 145
"c:\Users\Aqua\Programming\AeroJS\src\core\parser\ast\nodes\statements\control_flow.cpp", "C++", 211, 0, 0, 0, 29, 45, 285
"c:\Users\Aqua\Programming\AeroJS\src\core\parser\ast\nodes\statements\control_flow.h", "C++", 115, 0, 0, 0, 97, 46, 258
"c:\Users\Aqua\Programming\AeroJS\src\core\parser\ast\nodes\statements\debugger_statement.cpp", "C++", 38, 0, 0, 0, 14, 12, 64
"c:\Users\Aqua\Programming\AeroJS\src\core\parser\ast\nodes\statements\debugger_statement.h", "C++", 36, 0, 0, 0, 27, 13, 76
"c:\Users\Aqua\Programming\AeroJS\src\core\parser\ast\nodes\statements\expression_statement.cpp", "C++", 62, 0, 0, 0, 14, 15, 91
"c:\Users\Aqua\Programming\AeroJS\src\core\parser\ast\nodes\statements\expression_statement.h", "C++", 44, 0, 0, 0, 35, 16, 95
"c:\Users\Aqua\Programming\AeroJS\src\core\parser\ast\nodes\statements\labeled_statement.cpp", "C++", 74, 0, 0, 0, 13, 19, 106
"c:\Users\Aqua\Programming\AeroJS\src\core\parser\ast\nodes\statements\labeled_statement.h", "C++", 46, 0, 0, 0, 40, 18, 104
"c:\Users\Aqua\Programming\AeroJS\src\core\parser\ast\nodes\statements\loop_statements.cpp", "C++", 399, 0, 0, 0, 24, 97, 520
"c:\Users\Aqua\Programming\AeroJS\src\core\parser\ast\nodes\statements\loop_statements.h", "C++", 178, 0, 0, 0, 202, 75, 455
"c:\Users\Aqua\Programming\AeroJS\src\core\parser\ast\nodes\statements\statement_node.h", "C++", 33, 0, 0, 0, 41, 11, 85
"c:\Users\Aqua\Programming\AeroJS\src\core\parser\ast\nodes\statements\statements.cpp", "C++", 246, 0, 0, 0, 25, 46, 317
"c:\Users\Aqua\Programming\AeroJS\src\core\parser\ast\nodes\statements\statements.h", "C++", 121, 0, 0, 0, 116, 51, 288
"c:\Users\Aqua\Programming\AeroJS\src\core\parser\ast\nodes\statements\switch_statement.cpp", "C++", 176, 0, 0, 0, 23, 31, 230
"c:\Users\Aqua\Programming\AeroJS\src\core\parser\ast\nodes\statements\switch_statement.h", "C++", 74, 0, 0, 0, 71, 30, 175
"c:\Users\Aqua\Programming\AeroJS\src\core\parser\ast\nodes\statements\try_statement.cpp", "C++", 188, 0, 0, 0, 22, 37, 247
"c:\Users\Aqua\Programming\AeroJS\src\core\parser\ast\nodes\statements\try_statement.h", "C++", 79, 0, 0, 0, 86, 32, 197
"c:\Users\Aqua\Programming\AeroJS\src\core\parser\ast\nodes\statements\with_statement.cpp", "C++", 75, 0, 0, 0, 16, 19, 110
"c:\Users\Aqua\Programming\AeroJS\src\core\parser\ast\nodes\statements\with_statement.h", "C++", 46, 0, 0, 0, 44, 18, 108
"c:\Users\Aqua\Programming\AeroJS\src\core\parser\ast\visitors\ast_visitor.h", "C++", 424, 0, 0, 0, 64, 33, 521
"c:\Users\Aqua\Programming\AeroJS\src\core\parser\error_recovery.h", "C++", 128, 0, 0, 0, 144, 32, 304
"c:\Users\Aqua\Programming\AeroJS\src\core\parser\hyper_parser.h", "C++", 230, 0, 0, 0, 51, 51, 332
"c:\Users\Aqua\Programming\AeroJS\src\core\parser\incremental_parser.cpp", "C++", 395, 0, 0, 0, 78, 116, 589
"c:\Users\Aqua\Programming\AeroJS\src\core\parser\incremental_parser.h", "C++", 87, 0, 0, 0, 154, 35, 276
"c:\Users\Aqua\Programming\AeroJS\src\core\parser\json\json_parser.cpp", "C++", 835, 0, 0, 0, 105, 136, 1076
"c:\Users\Aqua\Programming\AeroJS\src\core\parser\json\json_parser.h", "C++", 256, 0, 0, 0, 515, 120, 891
"c:\Users\Aqua\Programming\AeroJS\src\core\parser\json\json_parser_benchmark.cpp", "C++", 0, 0, 0, 0, 0, 1, 1
"c:\Users\Aqua\Programming\AeroJS\src\core\parser\json\json_parser_test.cpp", "C++", 414, 0, 0, 0, 77, 74, 565
"c:\Users\Aqua\Programming\AeroJS\src\core\parser\lexer\lexer.cpp", "C++", 411, 0, 0, 0, 17, 61, 489
"c:\Users\Aqua\Programming\AeroJS\src\core\parser\lexer\lexer.h", "C++", 191, 0, 0, 0, 116, 54, 361
"c:\Users\Aqua\Programming\AeroJS\src\core\parser\lexer\lexer_perfect.cpp", "C++", 1619, 0, 0, 0, 215, 240, 2074
"c:\Users\Aqua\Programming\AeroJS\src\core\parser\lexer\scanner\scanner.cpp", "C++", 158, 0, 0, 0, 17, 42, 217
"c:\Users\Aqua\Programming\AeroJS\src\core\parser\lexer\scanner\scanner.h", "C++", 46, 0, 0, 0, 154, 33, 233
"c:\Users\Aqua\Programming\AeroJS\src\core\parser\lexer\token\token.cpp", "C++", 220, 0, 0, 0, 44, 37, 301
"c:\Users\Aqua\Programming\AeroJS\src\core\parser\lexer\token\token.h", "C++", 198, 0, 0, 0, 125, 46, 369
"c:\Users\Aqua\Programming\AeroJS\src\core\parser\parser.cpp", "C++", 1429, 0, 0, 0, 270, 239, 1938
"c:\Users\Aqua\Programming\AeroJS\src\core\parser\parser.h", "C++", 371, 0, 0, 0, 184, 87, 642
"c:\Users\Aqua\Programming\AeroJS\src\core\parser\parser_error.h", "C++", 312, 0, 0, 0, 136, 62, 510
"c:\Users\Aqua\Programming\AeroJS\src\core\parser\sourcemap\source_location.h", "C++", 44, 0, 0, 0, 52, 16, 112
"c:\Users\Aqua\Programming\AeroJS\src\core\parser\token.cpp", "C++", 2693, 0, 0, 0, 415, 355, 3463
"c:\Users\Aqua\Programming\AeroJS\src\core\parser\token.h", "C++", 405, 0, 0, 0, 132, 71, 608
"c:\Users\Aqua\Programming\AeroJS\src\core\quantum_jit.cpp", "C++", 103, 0, 0, 0, 13, 34, 150
"c:\Users\Aqua\Programming\AeroJS\src\core\runtime\README.md", "Markdown", 0, 56, 0, 0, 0, 18, 74
"c:\Users\Aqua\Programming\AeroJS\src\core\runtime\builtins\README.md", "Markdown", 0, 84, 0, 0, 0, 22, 106
"c:\Users\Aqua\Programming\AeroJS\src\core\runtime\builtins\array\array.cpp", "C++", 222, 0, 0, 0, 33, 64, 319
"c:\Users\Aqua\Programming\AeroJS\src\core\runtime\builtins\array\array.h", "C++", 54, 0, 0, 0, 263, 45, 362
"c:\Users\Aqua\Programming\AeroJS\src\core\runtime\builtins\array\array_iteration.cpp", "C++", 202, 0, 0, 0, 60, 69, 331
"c:\Users\Aqua\Programming\AeroJS\src\core\runtime\builtins\array\array_iterator.cpp", "C++", 203, 0, 0, 0, 46, 66, 315
"c:\Users\Aqua\Programming\AeroJS\src\core\runtime\builtins\array\array_manipulation.cpp", "C++", 336, 0, 0, 0, 89, 106, 531
"c:\Users\Aqua\Programming\AeroJS\src\core\runtime\builtins\array\array_methods.cpp", "C++", 228, 0, 0, 0, 57, 63, 348
"c:\Users\Aqua\Programming\AeroJS\src\core\runtime\builtins\array\array_search.cpp", "C++", 278, 0, 0, 0, 92, 97, 467
"c:\Users\Aqua\Programming\AeroJS\src\core\runtime\builtins\array\array_vector_ops.cpp", "C++", 147, 0, 0, 0, 71, 52, 270
"c:\Users\Aqua\Programming\AeroJS\src\core\runtime\builtins\array\array_vector_ops.h", "C++", 14, 0, 0, 0, 32, 9, 55
"c:\Users\Aqua\Programming\AeroJS\src\core\runtime\builtins\bigint\bigint.cpp", "C++", 807, 0, 0, 0, 125, 215, 1147
"c:\Users\Aqua\Programming\AeroJS\src\core\runtime\builtins\bigint\bigint.h", "C++", 59, 0, 0, 0, 209, 48, 316
"c:\Users\Aqua\Programming\AeroJS\src\core\runtime\builtins\boolean\boolean.cpp", "C++", 76, 0, 0, 0, 22, 28, 126
"c:\Users\Aqua\Programming\AeroJS\src\core\runtime\builtins\boolean\boolean.h", "C++", 25, 0, 0, 0, 58, 17, 100
"c:\Users\Aqua\Programming\AeroJS\src\core\runtime\builtins\boolean\module.cpp", "C++", 19, 0, 0, 0, 13, 7, 39
"c:\Users\Aqua\Programming\AeroJS\src\core\runtime\builtins\builtins_manager.cpp", "C++", 146, 0, 0, 0, 23, 36, 205
"c:\Users\Aqua\Programming\AeroJS\src\core\runtime\builtins\builtins_manager.h", "C++", 49, 0, 0, 0, 24, 18, 91
"c:\Users\Aqua\Programming\AeroJS\src\core\runtime\builtins\date\date.cpp", "C++", 549, 0, 0, 0, 62, 144, 755
"c:\Users\Aqua\Programming\AeroJS\src\core\runtime\builtins\date\date.h", "C++", 67, 0, 0, 0, 278, 57, 402
"c:\Users\Aqua\Programming\AeroJS\src\core\runtime\builtins\error\error.cpp", "C++", 417, 0, 0, 0, 80, 131, 628
"c:\Users\Aqua\Programming\AeroJS\src\core\runtime\builtins\error\error.h", "C++", 53, 0, 0, 0, 165, 32, 250
"c:\Users\Aqua\Programming\AeroJS\src\core\runtime\builtins\error\module.cpp", "C++", 9, 0, 0, 0, 13, 5, 27
"c:\Users\Aqua\Programming\AeroJS\src\core\runtime\builtins\finalization\finalization_registry.cpp", "C++", 277, 0, 0, 0, 97, 87, 461
"c:\Users\Aqua\Programming\AeroJS\src\core\runtime\builtins\finalization\finalization_registry.h", "C++", 60, 0, 0, 0, 137, 37, 234
"c:\Users\Aqua\Programming\AeroJS\src\core\runtime\builtins\finalization\module.cpp", "C++", 7, 0, 0, 0, 10, 4, 21
"c:\Users\Aqua\Programming\AeroJS\src\core\runtime\builtins\finalization\module_init.cpp", "C++", 32, 0, 0, 0, 16, 7, 55
"c:\Users\Aqua\Programming\AeroJS\src\core\runtime\builtins\function\function.cpp", "C++", 191, 0, 0, 0, 66, 63, 320
"c:\Users\Aqua\Programming\AeroJS\src\core\runtime\builtins\function\function.h", "C++", 52, 0, 0, 0, 113, 27, 192
"c:\Users\Aqua\Programming\AeroJS\src\core\runtime\builtins\function\module.cpp", "C++", 7, 0, 0, 0, 6, 4, 17
"c:\Users\Aqua\Programming\AeroJS\src\core\runtime\builtins\json\json.cpp", "C++", 618, 0, 0, 0, 116, 147, 881
"c:\Users\Aqua\Programming\AeroJS\src\core\runtime\builtins\json\json.h", "C++", 52, 0, 0, 0, 147, 41, 240
"c:\Users\Aqua\Programming\AeroJS\src\core\runtime\builtins\json\module.cpp", "C++", 32, 0, 0, 0, 15, 10, 57
"c:\Users\Aqua\Programming\AeroJS\src\core\runtime\builtins\map\map.cpp", "C++", 279, 0, 0, 0, 74, 84, 437
"c:\Users\Aqua\Programming\AeroJS\src\core\runtime\builtins\map\map.h", "C++", 52, 0, 0, 0, 125, 36, 213
"c:\Users\Aqua\Programming\AeroJS\src\core\runtime\builtins\math\math.cpp", "C++", 446, 0, 0, 0, 69, 124, 639
"c:\Users\Aqua\Programming\AeroJS\src\core\runtime\builtins\math\math.h", "C++", 58, 0, 0, 0, 31, 12, 101
"c:\Users\Aqua\Programming\AeroJS\src\core\runtime\builtins\modules.h", "C++", 28, 0, 0, 0, 10, 10, 48
"c:\Users\Aqua\Programming\AeroJS\src\core\runtime\builtins\number\module.cpp", "C++", 12, 0, 0, 0, 10, 5, 27
"c:\Users\Aqua\Programming\AeroJS\src\core\runtime\builtins\number\number.cpp", "C++", 450, 0, 0, 0, 78, 109, 637
"c:\Users\Aqua\Programming\AeroJS\src\core\runtime\builtins\number\number.h", "C++", 73, 0, 0, 0, 316, 50, 439
"c:\Users\Aqua\Programming\AeroJS\src\core\runtime\builtins\promise\promise.cpp", "C++", 699, 0, 0, 0, 194, 181, 1074
"c:\Users\Aqua\Programming\AeroJS\src\core\runtime\builtins\promise\promise.h", "C++", 83, 0, 0, 0, 19, 19, 121
"c:\Users\Aqua\Programming\AeroJS\src\core\runtime\builtins\promise\promise_static.cpp", "C++", 377, 0, 0, 0, 102, 130, 609
"c:\Users\Aqua\Programming\AeroJS\src\core\runtime\builtins\proxy\proxy.cpp", "C++", 761, 0, 0, 0, 225, 227, 1213
"c:\Users\Aqua\Programming\AeroJS\src\core\runtime\builtins\proxy\proxy.h", "C++", 79, 0, 0, 0, 18, 20, 117
"c:\Users\Aqua\Programming\AeroJS\src\core\runtime\builtins\regexp\module.cpp", "C++", 9, 0, 0, 0, 13, 5, 27
"c:\Users\Aqua\Programming\AeroJS\src\core\runtime\builtins\regexp\regexp.cpp", "C++", 563, 0, 0, 0, 164, 187, 914
"c:\Users\Aqua\Programming\AeroJS\src\core\runtime\builtins\regexp\regexp.h", "C++", 46, 0, 0, 0, 184, 35, 265
"c:\Users\Aqua\Programming\AeroJS\src\core\runtime\builtins\set\module.cpp", "C++", 19, 0, 0, 0, 13, 7, 39
"c:\Users\Aqua\Programming\AeroJS\src\core\runtime\builtins\set\set.cpp", "C++", 427, 0, 0, 0, 100, 123, 650
"c:\Users\Aqua\Programming\AeroJS\src\core\runtime\builtins\set\set.h", "C++", 48, 0, 0, 0, 157, 33, 238
"c:\Users\Aqua\Programming\AeroJS\src\core\runtime\builtins\string\string.cpp", "C++", 182, 0, 0, 0, 43, 48, 273
"c:\Users\Aqua\Programming\AeroJS\src\core\runtime\builtins\string\string.h", "C++", 62, 0, 0, 0, 314, 53, 429
"c:\Users\Aqua\Programming\AeroJS\src\core\runtime\builtins\string\string_manipulation.cpp", "C++", 290, 0, 0, 0, 63, 80, 433
"c:\Users\Aqua\Programming\AeroJS\src\core\runtime\builtins\string\string_methods.cpp", "C++", 321, 0, 0, 0, 66, 73, 460
"c:\Users\Aqua\Programming\AeroJS\src\core\runtime\builtins\string\string_static.cpp", "C++", 462, 0, 0, 0, 115, 123, 700
"c:\Users\Aqua\Programming\AeroJS\src\core\runtime\builtins\weakmap\module.cpp", "C++", 19, 0, 0, 0, 13, 7, 39
"c:\Users\Aqua\Programming\AeroJS\src\core\runtime\builtins\weakmap\weakmap.cpp", "C++", 220, 0, 0, 0, 77, 78, 375
"c:\Users\Aqua\Programming\AeroJS\src\core\runtime\builtins\weakmap\weakmap.h", "C++", 63, 0, 0, 0, 135, 32, 230
"c:\Users\Aqua\Programming\AeroJS\src\core\runtime\builtins\weakref\module.cpp", "C++", 7, 0, 0, 0, 10, 4, 21
"c:\Users\Aqua\Programming\AeroJS\src\core\runtime\builtins\weakref\module_init.cpp", "C++", 24, 0, 0, 0, 17, 7, 48
"c:\Users\Aqua\Programming\AeroJS\src\core\runtime\builtins\weakref\weakref.cpp", "C++", 104, 0, 0, 0, 44, 35, 183
"c:\Users\Aqua\Programming\AeroJS\src\core\runtime\builtins\weakref\weakref.h", "C++", 39, 0, 0, 0, 87, 25, 151
"c:\Users\Aqua\Programming\AeroJS\src\core\runtime\context.cpp", "C++", 331, 0, 0, 0, 39, 85, 455
"c:\Users\Aqua\Programming\AeroJS\src\core\runtime\context.h", "C++", 93, 0, 0, 0, 205, 61, 359
"c:\Users\Aqua\Programming\AeroJS\src\core\runtime\context\README.md", "Markdown", 0, 170, 0, 0, 0, 44, 214
"c:\Users\Aqua\Programming\AeroJS\src\core\runtime\context\api.cpp", "C++", 257, 0, 0, 0, 81, 79, 417
"c:\Users\Aqua\Programming\AeroJS\src\core\runtime\context\api.h", "C++", 30, 0, 0, 0, 98, 21, 149
"c:\Users\Aqua\Programming\AeroJS\src\core\runtime\context\context.cpp", "C++", 847, 0, 0, 0, 180, 223, 1250
"c:\Users\Aqua\Programming\AeroJS\src\core\runtime\context\context.h", "C++", 73, 0, 0, 0, 191, 42, 306
"c:\Users\Aqua\Programming\AeroJS\src\core\runtime\context\context_test.js", "JavaScript", 0, 0, 0, 149, 27, 37, 213
"c:\Users\Aqua\Programming\AeroJS\src\core\runtime\global_object.cpp", "C++", 473, 0, 0, 0, 69, 109, 651
"c:\Users\Aqua\Programming\AeroJS\src\core\runtime\global_object.h", "C++", 206, 0, 0, 0, 241, 69, 516
"c:\Users\Aqua\Programming\AeroJS\src\core\runtime\globals\globals.cpp", "C++", 1185, 0, 0, 0, 144, 308, 1637
"c:\Users\Aqua\Programming\AeroJS\src\core\runtime\globals\globals.h", "C++", 56, 0, 0, 0, 394, 50, 500
"c:\Users\Aqua\Programming\AeroJS\src\core\runtime\globals\globals_object.cpp", "C++", 127, 0, 0, 0, 47, 54, 228
"c:\Users\Aqua\Programming\AeroJS\src\core\runtime\globals\globals_object.h", "C++", 73, 0, 0, 0, 84, 24, 181
"c:\Users\Aqua\Programming\AeroJS\src\core\runtime\iteration\iteration.cpp", "C++", 662, 0, 0, 0, 172, 209, 1043
"c:\Users\Aqua\Programming\AeroJS\src\core\runtime\iteration\iteration.h", "C++", 74, 0, 0, 0, 279, 39, 392
"c:\Users\Aqua\Programming\AeroJS\src\core\runtime\object.h", "C++", 6, 0, 0, 0, 8, 1, 15
"c:\Users\Aqua\Programming\AeroJS\src\core\runtime\reflection\context\README.md", "Markdown", 0, 102, 0, 0, 0, 30, 132
"c:\Users\Aqua\Programming\AeroJS\src\core\runtime\reflection\context\context.cpp", "C++", 266, 0, 0, 0, 85, 78, 429
"c:\Users\Aqua\Programming\AeroJS\src\core\runtime\reflection\context\context.h", "C++", 31, 0, 0, 0, 117, 21, 169
"c:\Users\Aqua\Programming\AeroJS\src\core\runtime\reflection\context\context_test.js", "JavaScript", 0, 0, 0, 0, 0, 1, 1
"c:\Users\Aqua\Programming\AeroJS\src\core\runtime\reflection\reflect\module.cpp", "C++", 9, 0, 0, 0, 13, 5, 27
"c:\Users\Aqua\Programming\AeroJS\src\core\runtime\reflection\reflect\reflect.cpp", "C++", 247, 0, 0, 0, 67, 101, 415
"c:\Users\Aqua\Programming\AeroJS\src\core\runtime\reflection\reflect\reflect.h", "C++", 23, 0, 0, 0, 143, 21, 187
"c:\Users\Aqua\Programming\AeroJS\src\core\runtime\symbols\symbols.cpp", "C++", 379, 0, 0, 0, 66, 83, 528
"c:\Users\Aqua\Programming\AeroJS\src\core\runtime\symbols\symbols.h", "C++", 67, 0, 0, 0, 163, 36, 266
"c:\Users\Aqua\Programming\AeroJS\src\core\runtime\types\types.cpp", "C++", 465, 0, 0, 0, 89, 113, 667
"c:\Users\Aqua\Programming\AeroJS\src\core\runtime\types\types.h", "C++", 75, 0, 0, 0, 475, 62, 612
"c:\Users\Aqua\Programming\AeroJS\src\core\runtime\types\value_type.h", "C++", 262, 0, 0, 0, 55, 39, 356
"c:\Users\Aqua\Programming\AeroJS\src\core\runtime\values\array.cpp", "C++", 512, 0, 0, 0, 57, 126, 695
"c:\Users\Aqua\Programming\AeroJS\src\core\runtime\values\array.h", "C++", 68, 0, 0, 0, 200, 48, 316
"c:\Users\Aqua\Programming\AeroJS\src\core\runtime\values\bigint.cpp", "C++", 343, 0, 0, 0, 68, 95, 506
"c:\Users\Aqua\Programming\AeroJS\src\core\runtime\values\bigint.h", "C++", 76, 0, 0, 0, 228, 65, 369
"c:\Users\Aqua\Programming\AeroJS\src\core\runtime\values\bigint_ops.cpp", "C++", 487, 0, 0, 0, 127, 141, 755
"c:\Users\Aqua\Programming\AeroJS\src\core\runtime\values\function.cpp", "C++", 289, 0, 0, 0, 42, 81, 412
"c:\Users\Aqua\Programming\AeroJS\src\core\runtime\values\function.h", "C++", 114, 0, 0, 0, 139, 47, 300
"c:\Users\Aqua\Programming\AeroJS\src\core\runtime\values\object.cpp", "C++", 436, 0, 0, 0, 44, 91, 571
"c:\Users\Aqua\Programming\AeroJS\src\core\runtime\values\object.h", "C++", 113, 0, 0, 0, 271, 74, 458
"c:\Users\Aqua\Programming\AeroJS\src\core\runtime\values\string.cpp", "C++", 364, 0, 0, 0, 49, 94, 507
"c:\Users\Aqua\Programming\AeroJS\src\core\runtime\values\string.h", "C++", 118, 0, 0, 0, 191, 56, 365
"c:\Users\Aqua\Programming\AeroJS\src\core\runtime\values\symbol.cpp", "C++", 38, 0, 0, 0, 8, 11, 57
"c:\Users\Aqua\Programming\AeroJS\src\core\runtime\values\symbol.h", "C++", 51, 0, 0, 0, 42, 18, 111
"c:\Users\Aqua\Programming\AeroJS\src\core\runtime\values\symbol_perfect.cpp", "C++", 197, 0, 0, 0, 31, 49, 277
"c:\Users\Aqua\Programming\AeroJS\src\core\runtime\values\symbol_test.cpp", "C++", 214, 0, 0, 0, 42, 52, 308
"c:\Users\Aqua\Programming\AeroJS\src\core\runtime\values\value.cpp", "C++", 323, 0, 0, 0, 68, 71, 462
"c:\Users\Aqua\Programming\AeroJS\src\core\runtime\values\value.h", "C++", 308, 0, 0, 0, 67, 77, 452
"c:\Users\Aqua\Programming\AeroJS\src\core\runtime\wasm\wasm_adapters.cpp", "C++", 1185, 0, 0, 0, 112, 288, 1585
"c:\Users\Aqua\Programming\AeroJS\src\core\runtime\wasm\wasm_adapters.h", "C++", 133, 0, 0, 0, 214, 59, 406
"c:\Users\Aqua\Programming\AeroJS\src\core\runtime\wasm\wasm_api.cpp", "C++", 1260, 0, 0, 0, 288, 275, 1823
"c:\Users\Aqua\Programming\AeroJS\src\core\runtime\wasm\wasm_binary.cpp", "C++", 432, 0, 0, 0, 119, 145, 696
"c:\Users\Aqua\Programming\AeroJS\src\core\runtime\wasm\wasm_binary.h", "C++", 75, 0, 0, 0, 27, 18, 120
"c:\Users\Aqua\Programming\AeroJS\src\core\runtime\wasm\wasm_global.cpp", "C++", 276, 0, 0, 0, 14, 54, 344
"c:\Users\Aqua\Programming\AeroJS\src\core\runtime\wasm\wasm_global.h", "C++", 65, 0, 0, 0, 145, 35, 245
"c:\Users\Aqua\Programming\AeroJS\src\core\runtime\wasm\wasm_module.cpp", "C++", 1870, 0, 0, 0, 356, 499, 2725
"c:\Users\Aqua\Programming\AeroJS\src\core\runtime\wasm\wasm_module.h", "C++", 229, 0, 0, 0, 56, 60, 345
"c:\Users\Aqua\Programming\AeroJS\src\core\runtime\wasm\wasm_table.cpp", "C++", 470, 0, 0, 0, 87, 143, 700
"c:\Users\Aqua\Programming\AeroJS\src\core\runtime\wasm\wasm_table.h", "C++", 59, 0, 0, 0, 115, 29, 203
"c:\Users\Aqua\Programming\AeroJS\src\core\runtime\wasm\wasm_validator.cpp", "C++", 442, 0, 0, 0, 81, 103, 626
"c:\Users\Aqua\Programming\AeroJS\src\core\runtime\wasm\wasm_validator.h", "C++", 36, 0, 0, 0, 23, 10, 69
"c:\Users\Aqua\Programming\AeroJS\src\core\simple_engine.cpp", "C++", 82, 0, 0, 0, 19, 23, 124
"c:\Users\Aqua\Programming\AeroJS\src\core\simple_engine.h", "C++", 25, 0, 0, 0, 13, 11, 49
"c:\Users\Aqua\Programming\AeroJS\src\core\simple_value.cpp", "C++", 104, 0, 0, 0, 6, 19, 129
"c:\Users\Aqua\Programming\AeroJS\src\core\simple_value.h", "C++", 42, 0, 0, 0, 16, 12, 70
"c:\Users\Aqua\Programming\AeroJS\src\core\symbol.cpp", "C++", 60, 0, 0, 0, 19, 15, 94
"c:\Users\Aqua\Programming\AeroJS\src\core\symbol.h", "C++", 30, 0, 0, 0, 57, 19, 106
"c:\Users\Aqua\Programming\AeroJS\src\core\transformers\README.md", "Markdown", 0, 55, 0, 0, 0, 23, 78
"c:\Users\Aqua\Programming\AeroJS\src\core\transformers\arch\riscv_array_optimizations.cpp", "C++", 305, 0, 0, 0, 44, 74, 423
"c:\Users\Aqua\Programming\AeroJS\src\core\transformers\arch\riscv_array_optimizations.h", "C++", 71, 0, 0, 0, 85, 25, 181
"c:\Users\Aqua\Programming\AeroJS\src\core\transformers\array_optimization.cpp", "C++", 738, 0, 0, 0, 196, 196, 1130
"c:\Users\Aqua\Programming\AeroJS\src\core\transformers\array_optimization.h", "C++", 324, 0, 0, 0, 438, 105, 867
"c:\Users\Aqua\Programming\AeroJS\src\core\transformers\constant_folding.cpp", "C++", 832, 0, 0, 0, 52, 110, 994
"c:\Users\Aqua\Programming\AeroJS\src\core\transformers\constant_folding.h", "C++", 320, 0, 0, 0, 171, 75, 566
"c:\Users\Aqua\Programming\AeroJS\src\core\transformers\dead_code_elimination.cpp", "C++", 752, 0, 0, 0, 123, 139, 1014
"c:\Users\Aqua\Programming\AeroJS\src\core\transformers\dead_code_elimination.h", "C++", 146, 0, 0, 0, 189, 49, 384
"c:\Users\Aqua\Programming\AeroJS\src\core\transformers\identifier_lookup_optimization.cpp", "C++", 350, 0, 0, 0, 153, 80, 583
"c:\Users\Aqua\Programming\AeroJS\src\core\transformers\identifier_lookup_optimization.h", "C++", 56, 0, 0, 0, 107, 27, 190
"c:\Users\Aqua\Programming\AeroJS\src\core\transformers\inline_functions.cpp", "C++", 495, 0, 0, 0, 82, 116, 693
"c:\Users\Aqua\Programming\AeroJS\src\core\transformers\inline_functions.h", "C++", 82, 0, 0, 0, 143, 35, 260
"c:\Users\Aqua\Programming\AeroJS\src\core\transformers\optimizers_config.json", "JSON", 0, 0, 112, 0, 0, 0, 112
"c:\Users\Aqua\Programming\AeroJS\src\core\transformers\parallel_array_optimization.cpp", "C++", 926, 0, 0, 0, 0, 0, 926
"c:\Users\Aqua\Programming\AeroJS\src\core\transformers\parallel_array_optimization.h", "C++", 57, 0, 0, 0, 34, 15, 106
"c:\Users\Aqua\Programming\AeroJS\src\core\transformers\transform_pipeline_builder.h", "C++", 55, 0, 0, 0, 125, 27, 207
"c:\Users\Aqua\Programming\AeroJS\src\core\transformers\transformer.cpp", "C++", 566, 0, 0, 0, 102, 175, 843
"c:\Users\Aqua\Programming\AeroJS\src\core\transformers\transformer.h", "C++", 418, 0, 0, 0, 307, 96, 821
"c:\Users\Aqua\Programming\AeroJS\src\core\transformers\type_inference.cpp", "C++", 661, 0, 0, 0, 108, 173, 942
"c:\Users\Aqua\Programming\AeroJS\src\core\transformers\type_inference.h", "C++", 295, 0, 0, 0, 303, 109, 707
"c:\Users\Aqua\Programming\AeroJS\src\core\utils\logger.h", "C++", 171, 0, 0, 0, 73, 41, 285
"c:\Users\Aqua\Programming\AeroJS\src\core\value.cpp", "C++", 912, 0, 0, 0, 135, 214, 1261
"c:\Users\Aqua\Programming\AeroJS\src\core\value.h", "C++", 171, 0, 0, 0, 37, 31, 239
"c:\Users\Aqua\Programming\AeroJS\src\core\value_inline.h", "C++", 193, 0, 0, 0, 47, 61, 301
"c:\Users\Aqua\Programming\AeroJS\src\core\vm\README.md", "Markdown", 0, 53, 0, 0, 0, 25, 78
"c:\Users\Aqua\Programming\AeroJS\src\core\vm\bytecode\bytecode_generator.cpp", "C++", 434, 0, 0, 0, 147, 147, 728
"c:\Users\Aqua\Programming\AeroJS\src\core\vm\bytecode\bytecode_generator.h", "C++", 124, 0, 0, 0, 109, 30, 263
"c:\Users\Aqua\Programming\AeroJS\src\core\vm\bytecode\bytecode_module.cpp", "C++", 395, 0, 0, 0, 84, 124, 603
"c:\Users\Aqua\Programming\AeroJS\src\core\vm\bytecode\bytecode_module.h", "C++", 58, 0, 0, 0, 133, 31, 222
"c:\Users\Aqua\Programming\AeroJS\src\core\vm\bytecode\constant_pool.cpp", "C++", 298, 0, 0, 0, 53, 82, 433
"c:\Users\Aqua\Programming\AeroJS\src\core\vm\bytecode\constant_pool.h", "C++", 40, 0, 0, 0, 126, 27, 193
"c:\Users\Aqua\Programming\AeroJS\src\core\vm\bytecode\function_info.cpp", "C++", 167, 0, 0, 0, 91, 47, 305
"c:\Users\Aqua\Programming\AeroJS\src\core\vm\bytecode\function_info.h", "C++", 79, 0, 0, 0, 40, 18, 137
"c:\Users\Aqua\Programming\AeroJS\src\core\vm\bytecode\sourcemap_entry.cpp", "C++", 247, 0, 0, 0, 165, 74, 486
"c:\Users\Aqua\Programming\AeroJS\src\core\vm\bytecode\sourcemap_entry.h", "C++", 39, 0, 0, 0, 38, 10, 87
"c:\Users\Aqua\Programming\AeroJS\src\core\vm\calling\call_frame.cpp", "C++", 277, 0, 0, 0, 50, 79, 406
"c:\Users\Aqua\Programming\AeroJS\src\core\vm\calling\call_frame.h", "C++", 111, 0, 0, 0, 200, 41, 352
"c:\Users\Aqua\Programming\AeroJS\src\core\vm\exception\exception.cpp", "C++", 76, 0, 0, 0, 15, 25, 116
"c:\Users\Aqua\Programming\AeroJS\src\core\vm\exception\exception.h", "C++", 29, 0, 0, 0, 67, 19, 115
"c:\Users\Aqua\Programming\AeroJS\src\core\vm\interpreter\bytecode_instruction.cpp", "C++", 120, 0, 0, 0, 34, 22, 176
"c:\Users\Aqua\Programming\AeroJS\src\core\vm\interpreter\bytecode_instruction.h", "C++", 143, 0, 0, 0, 105, 31, 279
"c:\Users\Aqua\Programming\AeroJS\src\core\vm\interpreter\interpreter.cpp", "C++", 1007, 0, 0, 0, 312, 219, 1538
"c:\Users\Aqua\Programming\AeroJS\src\core\vm\interpreter\interpreter.h", "C++", 148, 0, 0, 0, 140, 49, 337
"c:\Users\Aqua\Programming\AeroJS\src\core\vm\stack\stack.cpp", "C++", 84, 0, 0, 0, 19, 32, 135
"c:\Users\Aqua\Programming\AeroJS\src\core\vm\stack\stack.h", "C++", 32, 0, 0, 0, 90, 23, 145
"c:\Users\Aqua\Programming\AeroJS\src\core\vm\vm.cpp", "C++", 396, 0, 0, 0, 68, 104, 568
"c:\Users\Aqua\Programming\AeroJS\src\core\vm\vm.h", "C++", 113, 0, 0, 0, 143, 33, 289
"c:\Users\Aqua\Programming\AeroJS\src\core\world_class_engine.cpp", "C++", 186, 0, 0, 0, 20, 55, 261
"c:\Users\Aqua\Programming\AeroJS\src\main.cpp", "C++", 315, 0, 0, 0, 19, 46, 380
"c:\Users\Aqua\Programming\AeroJS\src\utils\README.md", "Markdown", 0, 202, 0, 0, 0, 65, 267
"c:\Users\Aqua\Programming\AeroJS\src\utils\containers\README.md", "Markdown", 0, 75, 0, 0, 0, 28, 103
"c:\Users\Aqua\Programming\AeroJS\src\utils\containers\hashmap\hashmap.cpp", "C++", 207, 0, 0, 0, 53, 66, 326
"c:\Users\Aqua\Programming\AeroJS\src\utils\containers\hashmap\hashmap.h", "C++", 502, 0, 0, 0, 230, 108, 840
"c:\Users\Aqua\Programming\AeroJS\src\utils\containers\string\string_view.h", "C++", 322, 0, 0, 0, 42, 90, 454
"c:\Users\Aqua\Programming\AeroJS\src\utils\logging.cpp", "C++", 188, 0, 0, 0, 13, 39, 240
"c:\Users\Aqua\Programming\AeroJS\src\utils\logging.h", "C++", 186, 0, 0, 0, 38, 61, 285
"c:\Users\Aqua\Programming\AeroJS\src\utils\memory\README.md", "Markdown", 0, 69, 0, 0, 0, 30, 99
"c:\Users\Aqua\Programming\AeroJS\src\utils\memory\allocators\memory_allocator.cpp", "C++", 334, 0, 0, 0, 41, 97, 472
"c:\Users\Aqua\Programming\AeroJS\src\utils\memory\allocators\memory_allocator.h", "C++", 137, 0, 0, 0, 99, 38, 274
"c:\Users\Aqua\Programming\AeroJS\src\utils\memory\gc\garbage_collector.cpp", "C++", 738, 0, 0, 0, 140, 231, 1109
"c:\Users\Aqua\Programming\AeroJS\src\utils\memory\gc\garbage_collector.h", "C++", 130, 0, 0, 0, 109, 46, 285
"c:\Users\Aqua\Programming\AeroJS\src\utils\memory\gc\generational_gc.cpp", "C++", 833, 0, 0, 0, 209, 242, 1284
"c:\Users\Aqua\Programming\AeroJS\src\utils\memory\gc\generational_gc.h", "C++", 121, 0, 0, 0, 25, 40, 186
"c:\Users\Aqua\Programming\AeroJS\src\utils\memory\gc\incremental_gc.cpp", "C++", 732, 0, 0, 0, 83, 216, 1031
"c:\Users\Aqua\Programming\AeroJS\src\utils\memory\gc\incremental_gc.h", "C++", 232, 0, 0, 0, 51, 51, 334
"c:\Users\Aqua\Programming\AeroJS\src\utils\memory\gc\memory_leak_detector.cpp", "C++", 246, 0, 0, 0, 44, 73, 363
"c:\Users\Aqua\Programming\AeroJS\src\utils\memory\gc\memory_leak_detector.h", "C++", 71, 0, 0, 0, 19, 20, 110
"c:\Users\Aqua\Programming\AeroJS\src\utils\memory\gc\parallel_gc.cpp", "C++", 1160, 0, 0, 0, 215, 299, 1674
"c:\Users\Aqua\Programming\AeroJS\src\utils\memory\gc\parallel_gc.h", "C++", 273, 0, 0, 0, 62, 73, 408
"c:\Users\Aqua\Programming\AeroJS\src\utils\memory\gc\quantum_gc.h", "C++", 209, 0, 0, 0, 55, 43, 307
"c:\Users\Aqua\Programming\AeroJS\src\utils\memory\pool\memory_pool.cpp", "C++", 44, 0, 0, 0, 8, 16, 68
"c:\Users\Aqua\Programming\AeroJS\src\utils\memory\pool\memory_pool.h", "C++", 117, 0, 0, 0, 144, 45, 306
"c:\Users\Aqua\Programming\AeroJS\src\utils\memory\smart_ptr\handle_manager.cpp", "C++", 195, 0, 0, 0, 28, 54, 277
"c:\Users\Aqua\Programming\AeroJS\src\utils\memory\smart_ptr\handle_manager.h", "C++", 80, 0, 0, 0, 87, 32, 199
"c:\Users\Aqua\Programming\AeroJS\src\utils\memory\smart_ptr\ref_counted.h", "C++", 146, 0, 0, 0, 45, 34, 225
"c:\Users\Aqua\Programming\AeroJS\src\utils\memory\smart_ptr\weak_handle.h", "C++", 82, 0, 0, 0, 81, 22, 185
"c:\Users\Aqua\Programming\AeroJS\src\utils\platform\cpu_features.cpp", "C++", 245, 0, 0, 0, 54, 52, 351
"c:\Users\Aqua\Programming\AeroJS\src\utils\platform\cpu_features.h", "C++", 72, 0, 0, 0, 62, 26, 160
"c:\Users\Aqua\Programming\AeroJS\src\utils\platform\simd_operations.h", "C++", 200, 0, 0, 0, 124, 44, 368
"c:\Users\Aqua\Programming\AeroJS\src\utils\test_logging.cpp", "C++", 26, 0, 0, 0, 18, 12, 56
"c:\Users\Aqua\Programming\AeroJS\src\utils\time\timer.cpp", "C++", 56, 0, 0, 0, 6, 15, 77
"c:\Users\Aqua\Programming\AeroJS\src\utils\time\timer.h", "C++", 28, 0, 0, 0, 12, 10, 50
"c:\Users\Aqua\Programming\AeroJS\test_main.cpp", "C++", 168, 0, 0, 0, 21, 41, 230
"c:\Users\Aqua\Programming\AeroJS\tests\core\runtime\values\gc_test.cpp", "C++", 224, 0, 0, 0, 56, 72, 352
"c:\Users\Aqua\Programming\AeroJS\tests\core\runtime\values\symbol_test.cpp", "C++", 119, 0, 0, 0, 45, 35, 199
"c:\Users\Aqua\Programming\AeroJS\tests\core\runtime\values\value_test.cpp", "C++", 224, 0, 0, 0, 41, 51, 316
"c:\Users\Aqua\Programming\AeroJS\tests\core\test_context.cpp", "C++", 181, 0, 0, 0, 29, 52, 262
"c:\Users\Aqua\Programming\AeroJS\tests\core\test_engine.cpp", "C++", 127, 0, 0, 0, 25, 42, 194
"c:\Users\Aqua\Programming\AeroJS\tests\core\test_value.cpp", "C++", 194, 0, 0, 0, 36, 54, 284
"c:\Users\Aqua\Programming\AeroJS\tests\integration\engine_integration_test.cpp", "C++", 197, 0, 0, 0, 62, 64, 323
"c:\Users\Aqua\Programming\AeroJS\tests\jit\ir\ir_graph_test.cpp", "C++", 295, 0, 0, 0, 115, 103, 513
"c:\Users\Aqua\Programming\AeroJS\tests\jit\jit_compiler_test.cpp", "C++", 24, 0, 0, 0, 2, 3, 29
"c:\Users\Aqua\Programming\AeroJS\tests\jit\metatracing\trace_recorder_test.cpp", "C++", 200, 0, 0, 0, 65, 63, 328
"c:\Users\Aqua\Programming\AeroJS\tests\jit\optimizing_jit_test.cpp", "C++", 251, 0, 0, 0, 91, 89, 431
"c:\Users\Aqua\Programming\AeroJS\tests\jit\profiler\type_info_test.cpp", "C++", 267, 0, 0, 0, 76, 89, 432
"c:\Users\Aqua\Programming\AeroJS\tests\jit\riscv_vector_test.cpp", "C++", 134, 0, 0, 0, 84, 60, 278
"c:\Users\Aqua\Programming\AeroJS\tests\performance\jit_performance_test.cpp", "C++", 520, 0, 0, 0, 107, 116, 743
"c:\Users\Aqua\Programming\AeroJS\tests\performance\value_performance_test.cpp", "C++", 226, 0, 0, 0, 51, 54, 331
"c:\Users\Aqua\Programming\AeroJS\tests\transformers\identifier_lookup_optimization_test.cpp", "C++", 142, 0, 0, 0, 44, 37, 223
"c:\Users\Aqua\Programming\AeroJS\tests\transformers\parallel_array_optimization_test.cpp", "C++", 166, 0, 0, 0, 37, 51, 254
"c:\Users\Aqua\Programming\AeroJS\ultimate_test.cpp", "C++", 301, 0, 0, 0, 40, 63, 404
"c:\Users\Aqua\Programming\AeroJS\utils\memory\gc\generational_gc.cpp", "C++", 0, 0, 0, 0, 1, 0, 1
"c:\Users\Aqua\Programming\AeroJS\world_class_test.cpp", "C++", 251, 0, 0, 0, 27, 59, 337
"Total", "-", 157234, 6170, 112, 149, 53095, 40663, 257423